old_name	new_name
MIGS bacteria	MigsBa
MIGS eukaryote	MigsEu
MIGS org	MigsOrg
MIGS plant	MigsPl
MIGS virus	MigsVi
MIMAG	Mimag
MIMARKS specimen	MimarksC
MIMARKS survey	MimarksS
MIMS	Mims
MISAG	Misag
MIUVIG	Miuvig
agriculture	Agriculture
agriculture MIGS bacteria	MigsBaAgriculture
agriculture MIGS eukaryote	MigsEuAgriculture
agriculture MIGS org	MigsOrgAgriculture
agriculture MIGS plant	MigsPlAgriculture
agriculture MIGS virus	MigsViAgriculture
agriculture MIMAG	MimagAgriculture
agriculture MIMARKS specimen	MimarksCAgriculture
agriculture MIMARKS survey	MimarksSAgriculture
agriculture MIMS	MimsAgriculture
agriculture MISAG	MisagAgriculture
agriculture MIUVIG	MiuvigAgriculture
air	Air
air MIGS bacteria	MigsBaAir
air MIGS eukaryote	MigsEuAir
air MIGS org	MigsOrgAir
air MIGS plant	MigsPlAir
air MIGS virus	MigsViAir
air MIMAG	MimagAir
air MIMARKS specimen	MimarksCAir
air MIMARKS survey	MimarksSAir
air MIMS	MimsAir
air MISAG	MisagAir
air MIUVIG	MiuvigAir
built environment	BuiltEnvironment
built environment MIGS bacteria	MigsBaBuiltEnvironment
built environment MIGS eukaryote	MigsEuBuiltEnvironment
built environment MIGS org	MigsOrgBuiltEnvironment
built environment MIGS plant	MigsPlBuiltEnvironment
built environment MIGS virus	MigsViBuiltEnvironment
built environment MIMAG	MimagBuiltEnvironment
built environment MIMARKS specimen	MimarksCBuiltEnvironment
built environment MIMARKS survey	MimarksSBuiltEnvironment
built environment MIMS	MimsBuiltEnvironment
built environment MISAG	MisagBuiltEnvironment
built environment MIUVIG	MiuvigBuiltEnvironment
food-animal and animal feed	FoodAnimalAndAnimalFeed
food-animal and animal feed MIGS bacteria	MigsBaFoodAnimalAndAnimalFeed
food-animal and animal feed MIGS eukaryote	MigsEuFoodAnimalAndAnimalFeed
food-animal and animal feed MIGS org	MigsOrgFoodAnimalAndAnimalFeed
food-animal and animal feed MIGS plant	MigsPlFoodAnimalAndAnimalFeed
food-animal and animal feed MIGS virus	MigsViFoodAnimalAndAnimalFeed
food-animal and animal feed MIMAG	MimagFoodAnimalAndAnimalFeed
food-animal and animal feed MIMARKS specimen	MimarksCFoodAnimalAndAnimalFeed
food-animal and animal feed MIMARKS survey	MimarksSFoodAnimalAndAnimalFeed
food-animal and animal feed MIMS	MimsFoodAnimalAndAnimalFeed
food-animal and animal feed MISAG	MisagFoodAnimalAndAnimalFeed
food-animal and animal feed MIUVIG	MiuvigFoodAnimalAndAnimalFeed
food-farm environment	FoodFarmEnvironment
food-farm environment MIGS bacteria	MigsBaFoodFarmEnvironment
food-farm environment MIGS eukaryote	MigsEuFoodFarmEnvironment
food-farm environment MIGS org	MigsOrgFoodFarmEnvironment
food-farm environment MIGS plant	MigsPlFoodFarmEnvironment
food-farm environment MIGS virus	MigsViFoodFarmEnvironment
food-farm environment MIMAG	MimagFoodFarmEnvironment
food-farm environment MIMARKS specimen	MimarksCFoodFarmEnvironment
food-farm environment MIMARKS survey	MimarksSFoodFarmEnvironment
food-farm environment MIMS	MimsFoodFarmEnvironment
food-farm environment MISAG	MisagFoodFarmEnvironment
food-farm environment MIUVIG	MiuvigFoodFarmEnvironment
food-food production facility	FoodFoodProductionFacility
food-food production facility MIGS bacteria	MigsBaFoodFoodProductionFacility
food-food production facility MIGS eukaryote	MigsEuFoodFoodProductionFacility
food-food production facility MIGS org	MigsOrgFoodFoodProductionFacility
food-food production facility MIGS plant	MigsPlFoodFoodProductionFacility
food-food production facility MIGS virus	MigsViFoodFoodProductionFacility
food-food production facility MIMAG	MimagFoodFoodProductionFacility
food-food production facility MIMARKS specimen	MimarksCFoodFoodProductionFacility
food-food production facility MIMARKS survey	MimarksSFoodFoodProductionFacility
food-food production facility MIMS	MimsFoodFoodProductionFacility
food-food production facility MISAG	MisagFoodFoodProductionFacility
food-food production facility MIUVIG	MiuvigFoodFoodProductionFacility
food-human foods	FoodHumanFoods
food-human foods MIGS bacteria	MigsBaFoodHumanFoods
food-human foods MIGS eukaryote	MigsEuFoodHumanFoods
food-human foods MIGS org	MigsOrgFoodHumanFoods
food-human foods MIGS plant	MigsPlFoodHumanFoods
food-human foods MIGS virus	MigsViFoodHumanFoods
food-human foods MIMAG	MimagFoodHumanFoods
food-human foods MIMARKS specimen	MimarksCFoodHumanFoods
food-human foods MIMARKS survey	MimarksSFoodHumanFoods
food-human foods MIMS	MimsFoodHumanFoods
food-human foods MISAG	MisagFoodHumanFoods
food-human foods MIUVIG	MiuvigFoodHumanFoods
host-associated	HostAssociated
host-associated MIGS bacteria	MigsBaHostAssociated
host-associated MIGS eukaryote	MigsEuHostAssociated
host-associated MIGS org	MigsOrgHostAssociated
host-associated MIGS plant	MigsPlHostAssociated
host-associated MIGS virus	MigsViHostAssociated
host-associated MIMAG	MimagHostAssociated
host-associated MIMARKS specimen	MimarksCHostAssociated
host-associated MIMARKS survey	MimarksSHostAssociated
host-associated MIMS	MimsHostAssociated
host-associated MISAG	MisagHostAssociated
host-associated MIUVIG	MiuvigHostAssociated
human-associated	HumanAssociated
human-associated MIGS bacteria	MigsBaHumanAssociated
human-associated MIGS eukaryote	MigsEuHumanAssociated
human-associated MIGS org	MigsOrgHumanAssociated
human-associated MIGS plant	MigsPlHumanAssociated
human-associated MIGS virus	MigsViHumanAssociated
human-associated MIMAG	MimagHumanAssociated
human-associated MIMARKS specimen	MimarksCHumanAssociated
human-associated MIMARKS survey	MimarksSHumanAssociated
human-associated MIMS	MimsHumanAssociated
human-associated MISAG	MisagHumanAssociated
human-associated MIUVIG	MiuvigHumanAssociated
human-gut	HumanGut
human-gut MIGS bacteria	MigsBaHumanGut
human-gut MIGS eukaryote	MigsEuHumanGut
human-gut MIGS org	MigsOrgHumanGut
human-gut MIGS plant	MigsPlHumanGut
human-gut MIGS virus	MigsViHumanGut
human-gut MIMAG	MimagHumanGut
human-gut MIMARKS specimen	MimarksCHumanGut
human-gut MIMARKS survey	MimarksSHumanGut
human-gut MIMS	MimsHumanGut
human-gut MISAG	MisagHumanGut
human-gut MIUVIG	MiuvigHumanGut
human-oral	HumanOral
human-oral MIGS bacteria	MigsBaHumanOral
human-oral MIGS eukaryote	MigsEuHumanOral
human-oral MIGS org	MigsOrgHumanOral
human-oral MIGS plant	MigsPlHumanOral
human-oral MIGS virus	MigsViHumanOral
human-oral MIMAG	MimagHumanOral
human-oral MIMARKS specimen	MimarksCHumanOral
human-oral MIMARKS survey	MimarksSHumanOral
human-oral MIMS	MimsHumanOral
human-oral MISAG	MisagHumanOral
human-oral MIUVIG	MiuvigHumanOral
human-skin	HumanSkin
human-skin MIGS bacteria	MigsBaHumanSkin
human-skin MIGS eukaryote	MigsEuHumanSkin
human-skin MIGS org	MigsOrgHumanSkin
human-skin MIGS plant	MigsPlHumanSkin
human-skin MIGS virus	MigsViHumanSkin
human-skin MIMAG	MimagHumanSkin
human-skin MIMARKS specimen	MimarksCHumanSkin
human-skin MIMARKS survey	MimarksSHumanSkin
human-skin MIMS	MimsHumanSkin
human-skin MISAG	MisagHumanSkin
human-skin MIUVIG	MiuvigHumanSkin
human-vaginal	HumanVaginal
human-vaginal MIGS bacteria	MigsBaHumanVaginal
human-vaginal MIGS eukaryote	MigsEuHumanVaginal
human-vaginal MIGS org	MigsOrgHumanVaginal
human-vaginal MIGS plant	MigsPlHumanVaginal
human-vaginal MIGS virus	MigsViHumanVaginal
human-vaginal MIMAG	MimagHumanVaginal
human-vaginal MIMARKS specimen	MimarksCHumanVaginal
human-vaginal MIMARKS survey	MimarksSHumanVaginal
human-vaginal MIMS	MimsHumanVaginal
human-vaginal MISAG	MisagHumanVaginal
human-vaginal MIUVIG	MiuvigHumanVaginal
hydrocarbon resources-cores	HydrocarbonResourcesCores
hydrocarbon resources-cores MIGS bacteria	MigsBaHydrocarbonResourcesCores
hydrocarbon resources-cores MIGS eukaryote	MigsEuHydrocarbonResourcesCores
hydrocarbon resources-cores MIGS org	MigsOrgHydrocarbonResourcesCores
hydrocarbon resources-cores MIGS plant	MigsPlHydrocarbonResourcesCores
hydrocarbon resources-cores MIGS virus	MigsViHydrocarbonResourcesCores
hydrocarbon resources-cores MIMAG	MimagHydrocarbonResourcesCores
hydrocarbon resources-cores MIMARKS specimen	MimarksCHydrocarbonResourcesCores
hydrocarbon resources-cores MIMARKS survey	MimarksSHydrocarbonResourcesCores
hydrocarbon resources-cores MIMS	MimsHydrocarbonResourcesCores
hydrocarbon resources-cores MISAG	MisagHydrocarbonResourcesCores
hydrocarbon resources-cores MIUVIG	MiuvigHydrocarbonResourcesCores
hydrocarbon resources-fluids_swabs	HydrocarbonResourcesFluidsSwabs
hydrocarbon resources-fluids_swabs MIGS bacteria	MigsBaHydrocarbonResourcesFluidsSwabs
hydrocarbon resources-fluids_swabs MIGS eukaryote	MigsEuHydrocarbonResourcesFluidsSwabs
hydrocarbon resources-fluids_swabs MIGS org	MigsOrgHydrocarbonResourcesFluidsSwabs
hydrocarbon resources-fluids_swabs MIGS plant	MigsPlHydrocarbonResourcesFluidsSwabs
hydrocarbon resources-fluids_swabs MIGS virus	MigsViHydrocarbonResourcesFluidsSwabs
hydrocarbon resources-fluids_swabs MIMAG	MimagHydrocarbonResourcesFluidsSwabs
hydrocarbon resources-fluids_swabs MIMARKS specimen	MimarksCHydrocarbonResourcesFluidsSwabs
hydrocarbon resources-fluids_swabs MIMARKS survey	MimarksSHydrocarbonResourcesFluidsSwabs
hydrocarbon resources-fluids_swabs MIMS	MimsHydrocarbonResourcesFluidsSwabs
hydrocarbon resources-fluids_swabs MISAG	MisagHydrocarbonResourcesFluidsSwabs
hydrocarbon resources-fluids_swabs MIUVIG	MiuvigHydrocarbonResourcesFluidsSwabs
microbial mat_biofilm	MicrobialMatBiofilm
microbial mat_biofilm MIGS bacteria	MigsBaMicrobialMatBiofilm
microbial mat_biofilm MIGS eukaryote	MigsEuMicrobialMatBiofilm
microbial mat_biofilm MIGS org	MigsOrgMicrobialMatBiofilm
microbial mat_biofilm MIGS plant	MigsPlMicrobialMatBiofilm
microbial mat_biofilm MIGS virus	MigsViMicrobialMatBiofilm
microbial mat_biofilm MIMAG	MimagMicrobialMatBiofilm
microbial mat_biofilm MIMARKS specimen	MimarksCMicrobialMatBiofilm
microbial mat_biofilm MIMARKS survey	MimarksSMicrobialMatBiofilm
microbial mat_biofilm MIMS	MimsMicrobialMatBiofilm
microbial mat_biofilm MISAG	MisagMicrobialMatBiofilm
microbial mat_biofilm MIUVIG	MiuvigMicrobialMatBiofilm
miscellaneous natural or artificial environment	MiscellaneousNaturalOrArtificialEnvironment
miscellaneous natural or artificial environment MIGS bacteria	MigsBaMiscellaneousNaturalOrArtificialEnvironment
miscellaneous natural or artificial environment MIGS eukaryote	MigsEuMiscellaneousNaturalOrArtificialEnvironment
miscellaneous natural or artificial environment MIGS org	MigsOrgMiscellaneousNaturalOrArtificialEnvironment
miscellaneous natural or artificial environment MIGS plant	MigsPlMiscellaneousNaturalOrArtificialEnvironment
miscellaneous natural or artificial environment MIGS virus	MigsViMiscellaneousNaturalOrArtificialEnvironment
miscellaneous natural or artificial environment MIMAG	MimagMiscellaneousNaturalOrArtificialEnvironment
miscellaneous natural or artificial environment MIMARKS specimen	MimarksCMiscellaneousNaturalOrArtificialEnvironment
miscellaneous natural or artificial environment MIMARKS survey	MimarksSMiscellaneousNaturalOrArtificialEnvironment
miscellaneous natural or artificial environment MIMS	MimsMiscellaneousNaturalOrArtificialEnvironment
miscellaneous natural or artificial environment MISAG	MisagMiscellaneousNaturalOrArtificialEnvironment
miscellaneous natural or artificial environment MIUVIG	MiuvigMiscellaneousNaturalOrArtificialEnvironment
plant-associated	PlantAssociated
plant-associated MIGS bacteria	MigsBaPlantAssociated
plant-associated MIGS eukaryote	MigsEuPlantAssociated
plant-associated MIGS org	MigsOrgPlantAssociated
plant-associated MIGS plant	MigsPlPlantAssociated
plant-associated MIGS virus	MigsViPlantAssociated
plant-associated MIMAG	MimagPlantAssociated
plant-associated MIMARKS specimen	MimarksCPlantAssociated
plant-associated MIMARKS survey	MimarksSPlantAssociated
plant-associated MIMS	MimsPlantAssociated
plant-associated MISAG	MisagPlantAssociated
plant-associated MIUVIG	MiuvigPlantAssociated
sediment	Sediment
sediment MIGS bacteria	MigsBaSediment
sediment MIGS eukaryote	MigsEuSediment
sediment MIGS org	MigsOrgSediment
sediment MIGS plant	MigsPlSediment
sediment MIGS virus	MigsViSediment
sediment MIMAG	MimagSediment
sediment MIMARKS specimen	MimarksCSediment
sediment MIMARKS survey	MimarksSSediment
sediment MIMS	MimsSediment
sediment MISAG	MisagSediment
sediment MIUVIG	MiuvigSediment
soil	Soil
soil MIGS bacteria	MigsBaSoil
soil MIGS eukaryote	MigsEuSoil
soil MIGS org	MigsOrgSoil
soil MIGS plant	MigsPlSoil
soil MIGS virus	MigsViSoil
soil MIMAG	MimagSoil
soil MIMARKS specimen	MimarksCSoil
soil MIMARKS survey	MimarksSSoil
soil MIMS	MimsSoil
soil MISAG	MisagSoil
soil MIUVIG	MiuvigSoil
symbiont-associated	SymbiontAssociated
symbiont-associated MIGS bacteria	MigsBaSymbiontAssociated
symbiont-associated MIGS eukaryote	MigsEuSymbiontAssociated
symbiont-associated MIGS org	MigsOrgSymbiontAssociated
symbiont-associated MIGS plant	MigsPlSymbiontAssociated
symbiont-associated MIGS virus	MigsViSymbiontAssociated
symbiont-associated MIMAG	MimagSymbiontAssociated
symbiont-associated MIMARKS specimen	MimarksCSymbiontAssociated
symbiont-associated MIMARKS survey	MimarksSSymbiontAssociated
symbiont-associated MIMS	MimsSymbiontAssociated
symbiont-associated MISAG	MisagSymbiontAssociated
symbiont-associated MIUVIG	MiuvigSymbiontAssociated
wastewater_sludge	WastewaterSludge
wastewater_sludge MIGS bacteria	MigsBaWastewaterSludge
wastewater_sludge MIGS eukaryote	MigsEuWastewaterSludge
wastewater_sludge MIGS org	MigsOrgWastewaterSludge
wastewater_sludge MIGS plant	MigsPlWastewaterSludge
wastewater_sludge MIGS virus	MigsViWastewaterSludge
wastewater_sludge MIMAG	MimagWastewaterSludge
wastewater_sludge MIMARKS specimen	MimarksCWastewaterSludge
wastewater_sludge MIMARKS survey	MimarksSWastewaterSludge
wastewater_sludge MIMS	MimsWastewaterSludge
wastewater_sludge MISAG	MisagWastewaterSludge
wastewater_sludge MIUVIG	MiuvigWastewaterSludge
water	Water
water MIGS bacteria	MigsBaWater
water MIGS eukaryote	MigsEuWater
water MIGS org	MigsOrgWater
water MIGS plant	MigsPlWater
water MIGS virus	MigsViWater
water MIMAG	MimagWater
water MIMARKS specimen	MimarksCWater
water MIMARKS survey	MimarksSWater
water MIMS	MimsWater
water MISAG	MisagWater
water MIUVIG	MiuvigWater